TILEMAP
15 15 							-- Size of tile map in tiles (col x fila)
32 32 							-- Tile size & block size
images/tileset.png 	-- Tilesheet
13 13 								-- Number of tiles in tilesheet
000000000000000000000000000000
000000000000000000000000000000
000000000000000000000000000000
000000000000000000000000000000
000000000000000000000000000000
000000000000000000000000000000
000000000000000000000000000000
000000000000000000000000000000
000000000000000000000000000000
000000000000000000000000000000
000002000000000001000000000000
001415160000000101000000000000
141517181600010101000003040405
010101010101010101010101010101
010101010101010101010101010101

